A — прилагательное
ADV — наречие
ART — артикль
CLIT_PRO — местоименная клитика
CONJ — союз
FORM — форматив
INTJ — междометие
NOUN — существительное
NUM — числительное
PART — частица
PR — предлог
PRO — местоимение
V — глагол
VB_PART — глагольная формообразующая частица
1 — 1-е лицо
2 — 2-е лицо
3 — 3-е лицо
abl — аблатив
abl2 — аблатив 2
acc — аккузатив
acc_1pl — аккузативная клитика 1-го лица мн.ч.
acc_1sg — аккузативная клитика 1-го лица ед.ч.
acc_2pl — аккузативная клитика 2-го лица мн.ч.
acc_2sg — аккузативная клитика 2-го лица ед.ч.
acc_3pl — аккузативная клитика 3-го лица мн.ч.
acc_3sg — аккузативная клитика 3-го лица ед.ч.
act — активный залог
adm — адмиратив
anim — одушевленное существительное
aor — аорист
cont — контактная позиция артикля
dat_1pl — дативная клитика 1-го лица мн.ч.
dat_1sg — дативная клитика 1-го лица ед.ч.
dat_2pl — дативная клитика 2-го лица мн.ч.
dat_2sg — дативная клитика 2-го лица ед.ч.
dat_3pl — дативная клитика 3-го лица мн.ч.
dat_3sg — дативная клитика 3-го лица ед.ч.
def — определенная форма существительного
dist — дистантная позиция артикля
f — женский род
gen_dat — генитив-датив
Gheg — гегская лексема или словоформа
imp — императив
inanim — неодушевленное существительное
ind — индикатив
indef — неопределенная форма существительного
ipf — имперфект
loc — локатив
m — мужской род
med — медиальный глагол
mf — амбигенное существительное
n — средний род
nom — номинатив
nonst — нестандартная лексема или словоформа
opt — оптатив
pass — неактивный залог
pl — множественное число
pres — презенс
ptcp — причастие
sbjv — конъюнктив
sg — единственное число
unmkd — немаркированный падеж
vi — непереходный глагол
vt — переходный глагол
with_abl — предлог управляет аблативом
with_acc — предлог управляет аккузативом
with_loc — предлог управляет локативом
with_nom — предлог управляет номинативом